Aelrindel - Fireleaf - Feuerblatt
Aerendyl - Eagleflight - Adlerflug
Amakiir - Gemflower - Edelblüte
Amanodel - Rainbowmist - Regenbogennebel
Amastacia - Starflower - Sternenblüte
Ammathair - Starshade - Sternschatten
Anweth - Ashweaver - Ascheweber
Araushnee - Webspinner - Spinnweber
Ardulace - Snowblossom - Schneeknospe
Arvandor - Eveningstar - Abendstern
Auvryndar - Moonsong - Mondgesang
Avariel - Skyborn - Himmelgeboren
Aylith - Sunpetal - Sonnenblüte
Ayoris - Winddancer - Windtänzer
Belthil - Moonfire - Mondfeuer
Braerindra - Iceblossom - Eisknospe
Caerlorn - Wildwood - Wildwald
Calaquendi - Lightbearer - Lichtträger
Ciradyl - Nightfall - Nachtfall
Cormanthyr - Treehaven - Baumhain
Cymbeline - Swanqueen - Schwanenkönigin
Daro - Seashell - Muschel
Daurgothoth - Thundercloud - Donnerwolke
Draegloth - Spiderkin - Spinnenverwandter
Eirwynn - Snowdrop - Schneeglöckchen
Eledhel - Starlight - Sternenlicht
Elensar - Elvenstar - Elbenstern
Elué - Starwing - Sternflügel
Erevan - Wildheart - Wildherz
Erinor - Forestglade - Waldlichtung
Faelivrin - Dreamweaver - Traumweber
Faenith - Windwhisper - Windhauch
Fey-Branche - FairyBranch) - Feen-Zweig
Firiel - Mistyrose - Nebelrose
Gaelira - Moonwhisperer - Mondflüsterin
Galanodel - Moonwhisper - Mondhauch
Galladorn - Goldenleaf - Goldblatt
Gathelinn - Leafwalker - Blattwanderer
Ghelryn - Starglow - Sternenglanz
Gildor - Goldensong - Goldgesang
Gorvenal - Starseeker - Sternensucher
Haalija - Wintermoon - Wintermond
Haldalóke - Iceheart - Eisherz
Halisstra - Snakehair - Schlangenhaar
Hlarys - Shadowmist - Schattennebel
Holimion - Diamonddew - Diamanttropfen
Iliathor - Skydancer - Himmelstänzer
Illellah - Moonglade - Mondlichtung
Ilphelkiir - Gemblossom - Edelblütenknospe
Ilyndrathyl - Wintersong - Wintergesang
Immeril - Seawhisper - Meerflüstern
Iridal - Starseed - Sternensaat
Ithilwyn - Moonbloom - Mondblüte
Jalanthar - Silverbreeze - Silberwind
Jhaelryn - Starweaver - Sternweber
Kaerath - Stormwatcher - Sturmbeobachter
Kelethin - Treehaven - Baumhain
Kethryll'ia - Icesong - Eisklang
Kethryllia - Icebloom - Eisknospe
Kirith - Moonlit - Mondbeleuchtet
Kyriath - Dreamhunter - Traumjäger
Lathai - Windrider - Windreiter
Liadon - Silverfrond - Silberblatt
Liriel - Songbird - Singvogel
Lirielwen - Flowerdance - Blumentanz
Luthien - Enchantress - Zauberin
Maerdrym - Rainforest - Regenwald
Maeritha - Wildflower - Wildblume
Meliamne - Oakenheel - Eichensohle
Melwasúl - Honeyblossom - Honigblüte
Mythanthar - Mythalkeeper - Mythalhüters
Nai'lo - Nightbreeze - Nachtbrise
Naiadryl - Waterfall - Wasserfall
Naranduil - Frostblade - Frostklinge
Narwhal - Whalewatcher - Walbeobachter
Nelaeryn - Silentleaf - Stillblatt
Nerathul - Shadowlurk - Schattenlauern
Nesterin - Moonblade - Mondklinge
Nimlithiel - Moonweaver - Mondweberin
Nolatharn - Forestwhisper - Waldflüstern
Nymeria - Silvermist - Silbernebel
Orishaen - Forestborn - Waldgeboren
Ossë - Seaborn - Seegeschaffen
Pellanistra - Wildflower - Wildblume
Phaerl - Sunbright - Sonnenhell
Quaelin - Winterthorn - Winterdorn
Reluraun - Lightningbolt - Blitzschlag
Saelethil - Nightwalker - Nachtwanderer
Sariel - Windstorm - Windsturm
Selakiir - Moonstone - Mondstein
Sharwyn - Starflower - Sternenblume
Siannodel - Moonbrook - Mondbach
Sildëyuir - Moonspinner - Mondspinner
Sinafay - Dawnfire - Morgenglut
Sylfaeth - Greenleaf - Grünblatt
Syluné - Moonmaiden - Mondmaid
Thasitalia - Shadowmoon - Schattenmond
Tirahnn - Dewmist - Tauhauch
Tirithiel - Moonwatcher - Mondwächter
Tuilinn - Whirlwind - Wirbelwind
Tyvollus - Sunflower - Sonnenblume
Vadania - Forestspirit - Waldelementar
Valindra - Frostwillow - Frostweide
Vanya - Fairbreeze - Schönwind
Varda - Starbloom - Sternenblüte
Xanaphia - Shadowblossom - Schattenblüte
Xiloscient - Goldpetal - Goldblatt
Xylandra - Moonbeam - Mondstrahl
Yathlanae - Windrider - Windreiterin
Yrthraethra - Flowerblade - Blumenklinge
Zanathura - Wildsoul - Wildseele
Zirathel - Skydancer - Himmelstänzer