Brushgather - Pinselsammler
Goodbarrel - Gutfaß
Greenbottle - Grüneflasche
High-hill - Hochhügel
Hilltopple - Hügelstürzer
Tealeaf - Teeblatt
Thorngage - Dornenfang
Tosscobble - Wurfschuss
Underbough - Unterzweig
Birchbloom - Birkenblüte
Ashblaze - Eschenflamme
Cherrybloom - Kirschblüte
Everbloom - Immerblüte
Fernblossom - Farnblüte
Wildbranch - Wilder Ast
Berrybranch - Beerenast
Bramblebranch - Brombeerast
Thistlebranch - Distelast
Willowbranch - Weidenast
Cattailcreek - Schilfkreik
Riverreed - Flussrohr
Rushriver - Schilffluss
Stonyshore - Steinigstrand
Sandyshore - Sandigstrand
Dusktide - Dämmerflut
Dawnmist - Morgennebel
Moonlight - Mondschein
Starshine - Sternenschein
Sunburst - Sonnenexplosion
Raincloud - Regenwolke
Stormcloud - Sturmewolke
Skydancer - Himmelstänzer
Windwhisper - Windgeflüster
Mistyfrost - Nebelfrost
Snowdrift - Schneewehe
Frostfire - Frostfeuer
Icestorm - Eissturm
Mountainpeak - Berggipfel
Valleyview - Talblick
Leafyglade - Blätterlichtung
Moonglow - Mondlicht
Sunflower - Sonnenblume
Daisyfield - Gänseblümchenfeld
Lavenderhill - Lavendelhügel
Oceanview - Meerblick
Beachcomber - Strandgänger
Seashell - Muschel
Starfish - Seestern
Coralreef - Korallenriff
Grassyknoll - Wiesenkuppe
Fallowfield - Brachland
Harvestmoon - Erntemond
Farmstead - Bauernhof
Cidermill - Apfelmosterei
Honeybee - Honigbiene
Meadowlark - Wiesenlerche
Gardenpath - Gartenpfad
Rosepetal - Rosenblüte
Irisbloom - Irisblüte
Lilypad - Seerosenblatt
Dragonfly - Libelle
Firefly - Glühwürmchen
Butterfly - Schmetterling
Bumblebee - Hummel
Ladybug - Marienkäfer
Antlered - Geweihträger
Ravenwing - Rabenschwingen
Wolfheart - Wolfsherz
Lionmane - Löwenmähne
Bullhorn - Stierhorn
Furryfoot - Fellpfote
Snowpaw - Schneepfote
Swiftwing - Schnellflügel
Graytail - Grauschwanz
Redclaw - Rotkralle
Silvermane - Silbermähne
Darkmoon - Dunkelmond
Goldenleaf - Goldblatt
Featherwind - Federwind
Blackheart - Schwarzes Herz
Nightshade - Nachtschatten
Flamefur - Flammenfell
Thornclaw - Dornenkralle
Ironjaw - Eisenkiefer
Longwhisker - Langwhisker
Thunderstrike - Donnerschlag
Icefang - Eisfänge
Wildflower - Wildblume
Bluebird - Blaumeise
Oakleaf - Eichenblatt
Stonepath - Steinpfad
Darkforest - Dunkler Wald
Lightstream - Lichtstrom
Timberwolf - Timberwolf
Goldeneye - Goldauge
Swiftfoot - Schnellpfote
Redblade - Rotklinge
Nightwing - Nachtschwinge
Darkwing - Dunkelschwinge
Emberclaw - Glutkralle
Steelheart - Stahlherz
Windrunner - Windläufer
Silverclaw - Silberkralle
Oceanbreeze - Meeresbrise
Skyview - Himmelsblick
Forestshade - Waldschatten
Riverstone - Flussstein
Lightningstrike - Blitzschlag
Thunderbolt - Donnerkeil
Stonebloom - Steingeburt
Furryface - Fellgesicht
Swiftclaw - Schnellkralle
Redstripe - Rotstreifen
Snowtail - Schneeschwanz
Starrynight - Sternennacht
Sunray - Sonnenstrahl
Moonshadow - Mondschatten
Leafblaze - Blattflamme
Oceanwave - Meereswelle
Nightfall - Nachtfall
Silentwing - Stille Schwinge
Shadowclaw - Schattenkralle
Silverfang - Silberfänge
Woodland - Waldland
Thunderstorm - Gewittersturm
Goldendawn - Morgengold
Amberfire - Bernsteinfeuer
Blazeheart - Flammenherz
Bluebloom - Blaue Blüte
Breezeblaze - Brisenflamme
Caramelcloud - Karamellwolke
Crimsonclaw - Purpurkralle
Dappledawn - Morgentupfen
Dewdrop - Taukugel
Dreamdust - Traumstaub
Emeraldleaf - Smaragdblatt
Emberheart - Glutherz
Fallentree - Sägebaum
Fireheart - Feuerherz
Flameclaw - Flammenkralle
Forestclaw - Waldkralle
Frostclaw - Frostkralle
Ghostmoon - Geistermond
Goldenarrow - Goldpfeil
Graysky - Himmelgrau
Greenfrost - Grünfrost
Honeydew - Honigmelone
Ivybloom - Efeublüte
Lavendermist - Lavendelnebel
Leafstorm - Blattsturm
Lightningclaw - Blitzkralle
Lilacbreeze - Fliederbrise
Mapleleaf - Ahornblatt
Mistycloud - Nebelwolke
Moonlight - Mondlicht
Nightclaw - Nachtpranke
Oceanmist - Meeresnebel
Pinecone - Tannenzapfen
Rainstorm - Regensturm
Ravenwing - Rabenschwinge
Rosepetal - Rosenblüte
Runningwater - Flusswasser
Sandstorm - Sandsturm
Shadowfang - Schattenzahn
Sharpclaw - Scharfkralle
Silverfur - Silberfell
Skyfeather - Himmelsfeder
Dwarfflower - Zwergblume
Snowflake - Schneeflocke
Softpaw - Sanftpfote
Spottedfur - Fleckenfell
Springbreeze - Frühlingsbrise
Stormcloud - Sturmcloud
Sunflower - Sonnenblume
Sunkiss - Sonnenkuss
Sweetbloom - Süßblüte
Swiftstrike - Schnellstreich
Tawnyfur - Braunfell
Thornheart - Dornenherz
Thunderfoot - Donnerfuß
Tigerstripe - Tigerstreifen
Treepaw - Baumpranke
Violetsky - Violethimmel
Waterfall - Wasserfall
Whitetail - Weißwedel
Wildheart - Wildherz
Willowbreeze - Weidenbrise
Windwhisper - Windflüstern
Winterstorm - Wintersturm
Yellowclaw - Gelbkralle
Amberpaw - Bernsteinpfote
Blazefeather - Flammenfeder
Blossomheart - Blütenherz
Boulderstone - Felsstein
Cedarbark - Zedernrinde
Cinderpaw - Aschepfote
Clawstrike - Kralleinschlag
Copperleaf - Kupferblatt
Darkstone - Dunkler Stein
Dewbreeze - Tauluft
Dustycloud - Staubschwaden
Fernleaf - Farnblatt
Flintclaw - Feuerkralle
Frostfur - Frostfell
Hailstorm - Hagelsturm
Hazelnut - Haselnuss
Heatherbloom - Heidekrautblüte